00100101010
00100000010
10111101110
10001001000
10101011011
00101001000
01100001010
00101111010
00100100010
00100001010
